###############
#S            #
#  ####       #
#  ####       #
#  ####       #
#             #
#           ###
#     ####  ###
#     ####  ###
#             #
#     ##   ## #
#     ##   ## #
#     ##   ## #
#     ##     E#
###############