#####################
#         S         #
#                   #
#                   #
#                   #
#                   #
#                   #
#                   #
#                   #
#                   #
#####################
#                   #
#                   #
#                   #
#                   #
#                   #
#                   #
#                   #
#                   #
#         E         #
#####################