###############
#     #     #E#
##### # ### # #
#   #   ### # #
# # # #   #   #
# # # ### #####
# # #         #
### ### # #####
#     # #     #
# ### # #  ## #
# # # ### ##  #
# # #     #   #
### ##### ### #
#S            #
###############