#####################
#                   #
#S################# #
#                 # #
################# # #
#               # # #
# ############# # # #
# #           # # # #
# # ######### # # # #
# # #       # # # # #
# # # ##### # # # # #
# # # #   # # # # # #
# # # # E ### # # # #
# # # #       # # # #
# # # ######### # # #
# # #           # # #
# # ############# # #
# #               # #
# ################# #
#                   #
#####################